000000000000000000000000000000000
000000000000000000000000000000000
000000000000000000000000000000000
000000000000000000000000000000000
000000000000000000000000000000000
000000000000000000000000000000000
222000000002222222222222222222222
111222000000111111111111111111110
111111000000001111111111111111000
111110000000000000111111000000000
110000000000000000000000000000000
000000022222222222222000000000000
000000001111111111110000000000000
000000000001111111100000000000000
